1111111111111111111111111111111111111
1P0C0000100010000010000000100C1C00001
1011111010111011101010111010111011101
10100010001000100010000010000C1C00C01
1010111010111010111010111010111011101
10000010100000100010000010000C1C00001
1111101010111111101110111010111011111
10000010001C00010001000010000C1C00001
1011111011111011101010111010111011101
10100C1C00001C000010100010000C1C00001
1010111010111111010111010111010111011
10000C100000100C00EC000010000C0000001
1111111111111111111111111111111111111