11111111111111111111
1P0000001000000000C1
111111101C1111111101
1E100010101000000101
10101010101C11110101
10100010001000C1C101
10101111101011110101
100000000000C1C000C1
11111111111111111111