1111111111111111111111111111111111111
1P000000000000000000000000000000100C1
1011111111111111111111111111111011101
101C000000000000C10000000000001000101
1010111111111111011111111111111011101
101C001000000000C1000000000000100C1C1
1010111011111111011111111111111011101
101C001000000000C1000000000000100C101
1011111011111111111111111111111011101
100C001000000000C100000000000010C0001
1010111011111111011111111111111011101
101C001000000000C10000000000001000101
1011111011111111011111111111111011101
1010000000000000C10000000000001000101
101C111111111111011111111111111011101
1C000000000000000C00000000000010C00E1
1111111111111111111111111111111111111