11111111
10P00E01
10000001
10000001
10000001
10000001
11111111