111111111
100000001
10P000001
100000001
1000C0001
100000001
100000001
10000E001
100000001
100000001
110111111