111111
1P0001
100C01
111111
100001
100E01
111111