1111111
10P0C01
1000001
1000E01
1001001
111111