1111111
1P000E1
1111111
1000001
10C0001
1111111