111111111
100000001
10P000001
100000001
100000001
10E000000
100000001
10C000001
111111111