111111111
1P0000001
1000C0001
1000000E1
100000001
1000e0001
100000001
111111111