11111111
10C0E001
10000001
10000001
10000001
10000001
11111111