111111
1P0001
10E001
100C01
100001
10001
111111
111111
111111