11111111
10P00001
100C0001
10000001
10000001
10000001
11111111