111111111
1P10C01E1
101010101
101010101
101010101
101010101
101010101
1C0C1C0C1
111111111