11111111111111111111111111111111111111111111111111111111111111111111111111111111111
1P1C0010C010C0111111111111111111111110C0000C000C0010000C00000000C0000000C000000C001
101010101010100000C0000C0000C0000C0010111111111110111111111111110111111111111111101
1C0010C010C0111111111111111111111110C0100000000010C0000C0000C00001E000000000C000001
11111111111111111111111111111111111111111111111111111111111111111111111111111111111