11111
1P001
11101
1C1C1
10101
10101
10101
10101
10101
10101
10101
10101
10101
10101
10101
10101
10101
10101
10101
10101
10001
10111
1C1C1
10101
10101
10101
10101
10101
10101
10101
10101
10101
10101
10101
10101
10101
10101
10101
10101
10101
10101
10101
10101
10101
10101
10101
10101
10001
10111
10001
11101
10001
10111
10001
11101
10001
10111
10001
11101
10001
10111
10001
11101
10001
10111
10001
11101
10001
10111
10001
11101
10001
1E111
11111