111111111111111
1C0P0000000E0C1
11C000000000C11
111C0000000C111
1111C00000C1111
11111C000C11111
111111C0C111111
1111111C1111111
111111C0C111111
11111C000C11111
1111C00000C1111
111C0000000C111
11C000000000C11
1C00000000000C1
111111111111111