111111111111111
1C0P0000000E0C1
11C000000000C11
111111111111111