1111111111
1P00C00E01
1111111111